0 0 0 0 0 0 0 0 0 0 0 0 0 0 0 0
1 5 4 2 1 5 4 0 0 0 0 0 0 0 0 0
1 5 4 2 1 5 4 0 0 0 0 0 0 0 0 0
2 1 5 4 2 1 5 4 0 0 0 0 0 0 0 0
2 1 5 4 2 1 5 4 0 0 0 0 0 0 0 0
3 2 2 0 0 0 0 0 0 0 0 0 0 0 0 0
2 3 3 0 0 0 0 0 0 0 0 0 0 0 0 0
0 0 0 0 0 0 0 0 0 0 0 0 0 0 0 0

1