0 0 0 0 0 0 0 0 0 0 0 0 0 0 0 0
1 1 5 1 0 0 0 0 0 0 0 0 0 0 0 0
4 4 5 4 1 0 0 0 0 0 0 0 0 0 0 0
1 3 2 3 3 1 1 0 0 0 0 0 0 0 0 0
1 3 5 3 3 1 1 0 0 0 0 0 0 0 0 0
4 4 2 4 1 0 0 0 0 0 0 0 0 0 0 0
1 1 2 1 0 0 0 0 0 0 0 0 0 0 0 0
0 0 0 0 0 0 0 0 0 0 0 0 0 0 0 0

3