0 0 0 0 0 0 0 0 0 0 0 0 0 0 0 0
5 5 4 5 0 0 0 0 0 0 0 0 0 0 0 0
2 2 4 2 5 0 0 0 0 0 0 0 0 0 0 0
3 3 1 3 0 0 0 0 0 0 0 0 0 0 0 0
3 3 4 3 0 0 0 0 0 0 0 0 0 0 0 0
2 2 1 2 5 0 0 0 0 0 0 0 0 0 0 0
5 5 1 5 0 0 0 0 0 0 0 0 0 0 0 0
0 0 0 0 0 0 0 0 0 0 0 0 0 0 0 0

3