1 1 3 4 0 0 0 0 0 0 0 0 0 0 0 0
5 4 1 0 0 0 0 0 0 0 0 0 0 0 0 0
5 2 3 4 0 0 0 0 0 0 0 0 0 0 0 0
2 2 3 0 0 0 0 0 0 0 0 0 0 0 0 0
5 0 0 0 0 0 0 0 0 0 0 0 0 0 0 0
0 0 0 0 0 0 0 0 0 0 0 0 0 0 0 0
0 0 0 0 0 0 0 0 0 0 0 0 0 0 0 0
0 0 0 0 0 0 0 0 0 0 0 0 0 0 0 0

2