5 4 5 2 0 0 0 0 0 0 0 0 0 0 0 0
3 4 5 2 4 0 0 0 0 0 0 0 0 0 0 0
5 5 2 4 3 5 1 2 4 0 0 0 0 0 0 0
3 2 3 1 4 0 0 0 0 0 0 0 0 0 0 0
3 2 3 1 0 0 0 0 0 0 0 0 0 0 0 0
0 0 0 0 0 0 0 0 0 0 0 0 0 0 0 0
0 0 0 0 0 0 0 0 0 0 0 0 0 0 0 0
0 0 0 0 0 0 0 0 0 0 0 0 0 0 0 0

1