0 0 0 0 0 0 0 0 0 0 0 0 0 0 0 0
1 5 1 1 3 1 0 0 0 0 0 0 0 0 0 0
3 4 5 2 1 0 0 0 0 0 0 0 0 0 0 0
3 4 5 2 4 5 2 1 1 0 0 0 0 0 0 0
2 5 4 5 2 1 4 1 5 0 0 0 0 0 0 0
4 4 2 1 4 1 5 0 0 0 0 0 0 0 0 0
4 4 1 5 0 0 0 0 0 0 0 0 0 0 0 0
0 0 0 0 0 0 0 0 0 0 0 0 0 0 0 0

1