0 0 0 0 0 0 0 0 0 0 0 0 0 0 0 0
1 2 4 0 0 0 0 0 0 0 0 0 0 0 0 0
5 1 2 4 0 0 0 0 0 0 0 0 0 0 0 0
4 4 1 3 2 5 4 1 0 0 0 0 0 0 0 0
5 4 1 3 2 5 4 1 0 0 0 0 0 0 0 0
5 3 5 1 0 0 0 0 0 0 0 0 0 0 0 0
3 5 1 0 0 0 0 0 0 0 0 0 0 0 0 0
0 0 0 0 0 0 0 0 0 0 0 0 0 0 0 0

2