0 0 0 0 0 0 0 0 0 0 0 0 0 0 0 0
1 5 1 0 0 0 0 0 0 0 0 0 0 0 0 0
2 1 2 2 0 0 0 0 0 0 0 0 0 0 0 0
3 5 3 3 0 0 0 0 0 0 0 0 0 0 0 0
1 5 2 1 0 0 0 0 0 0 0 0 0 0 0 0
2 1 1 2 0 0 0 0 0 0 0 0 0 0 0 0
2 1 2 2 0 0 0 0 0 0 0 0 0 0 0 0
0 0 0 0 0 0 0 0 0 0 0 0 0 0 0 0

2