0 0 0 0 0 0 0 0 0 0 0 0 0 0 0 0
5 1 5 5 4 0 0 0 0 0 0 0 0 0 0 0
4 0 0 0 0 0 0 0 0 0 0 0 0 0 0 0
5 2 1 2 5 5 1 4 0 0 0 0 0 0 0 0
5 1 2 1 5 5 2 4 0 0 0 0 0 0 0 0
4 0 0 0 0 0 0 0 0 0 0 0 0 0 0 0
5 2 5 5 4 0 0 0 0 0 0 0 0 0 0 0
0 0 0 0 0 0 0 0 0 0 0 0 0 0 0 0

4