0 0 0 0 0 0 0 0 0 0 0 0 0 0 0 0
1 5 1 1 3 0 0 0 0 0 0 0 0 0 0 0
1 4 5 1 1 3 0 0 0 0 0 0 0 0 0 0
3 4 5 0 0 0 0 0 0 0 0 0 0 0 0 0
1 1 2 0 0 0 0 0 0 0 0 0 0 0 0 0
1 3 4 4 2 2 0 0 0 0 0 0 0 0 0 0
0 0 0 0 0 0 0 0 0 0 0 0 0 0 0 0
0 0 0 0 0 0 0 0 0 0 0 0 0 0 0 0

3