0 0 0 0 0 0 0 0 0 0 0 0 0 0 0 0
0 0 0 0 0 0 0 0 0 0 0 0 0 0 0 0
1 1 5 1 0 0 0 0 0 0 0 0 0 0 0 0
4 4 5 4 4 3 0 0 0 0 0 0 0 0 0 0
3 2 2 4 0 0 0 0 0 0 0 0 0 0 0 0
2 3 4 5 0 0 0 0 0 0 0 0 0 0 0 0
0 0 0 0 0 0 0 0 0 0 0 0 0 0 0 0
0 0 0 0 0 0 0 0 0 0 0 0 0 0 0 0

3